{
	"map_data" : [
		1,1,1,1,1,1,1,1,1,1,1,1,1,1,1,1,1,1,1,1,1,1,1,1,1,1,1,1,
		1,0,0,0,0,0,0,0,0,0,0,0,0,0,0,0,0,0,0,0,0,0,0,0,0,0,0,1,
		1,0,0,0,0,0,0,0,0,0,0,0,0,0,0,0,0,0,0,0,0,0,0,0,0,0,0,1,
		1,0,0,2,0,0,0,0,0,1,0,0,2,0,0,0,0,0,0,0,0,0,0,0,0,0,0,1,
		1,0,0,0,0,0,0,0,0,0,0,0,0,0,0,0,0,0,0,0,0,0,0,0,0,0,0,1,
		1,0,0,2,0,0,0,0,0,1,0,0,0,0,0,2,0,0,2,0,0,2,0,0,2,0,0,1,
		1,0,0,0,0,0,0,0,0,0,0,0,0,0,0,0,0,0,0,0,0,0,0,0,0,0,0,1,
		1,0,0,1,0,1,2,1,1,2,0,1,1,1,0,0,0,0,0,0,0,0,0,0,0,0,0,1,
		1,0,0,0,0,0,0,0,0,0,0,0,0,0,0,0,0,0,0,0,0,0,0,0,0,0,0,1,
		1,0,0,0,0,0,0,0,0,0,0,0,0,0,0,0,0,0,0,0,0,0,0,0,0,0,0,1,
		1,0,0,0,0,0,0,0,0,0,0,0,0,0,0,0,0,0,0,0,0,0,0,0,0,0,0,1,
		1,0,0,0,0,0,0,0,0,0,0,0,0,0,0,0,0,0,0,0,0,0,0,0,0,0,0,1,
		1,0,0,0,0,0,0,0,0,0,0,0,0,0,0,0,0,0,0,0,0,0,0,0,0,0,0,1,
		1,0,0,0,0,0,0,0,0,0,0,0,0,0,0,0,0,0,0,0,0,0,0,0,0,0,0,1,
		1,0,0,0,0,0,0,0,0,0,0,0,0,0,0,0,0,0,0,0,0,0,0,0,0,0,0,1,
		1,0,0,0,0,0,0,0,0,0,0,0,0,0,0,0,0,0,0,0,0,0,0,0,0,0,0,1,
		1,0,0,0,0,0,0,0,0,0,0,0,0,0,0,0,0,2,0,2,0,2,0,2,0,2,0,1,
		1,0,0,0,0,0,0,0,0,0,0,0,0,0,0,0,0,0,2,0,2,0,2,0,2,0,0,1,
		1,0,0,0,0,0,0,0,0,0,0,0,2,2,2,0,0,2,0,2,0,2,0,2,0,2,0,1,
		1,0,0,0,0,0,0,0,0,0,0,0,2,0,2,0,0,0,2,0,2,0,2,0,2,0,0,1,
		1,0,0,0,0,0,0,0,0,0,0,0,2,0,2,0,0,2,0,2,0,2,0,2,0,2,0,1,
		1,0,0,0,0,0,0,0,0,0,0,0,0,2,0,0,0,0,2,0,2,0,2,0,2,0,0,1,
		1,0,0,0,0,0,0,0,0,0,0,0,0,0,0,0,0,2,0,2,0,2,0,2,0,2,0,1,
		1,0,0,0,0,0,0,0,0,0,0,0,0,0,0,0,0,0,2,0,2,0,2,0,2,0,0,1,
		1,0,0,0,0,0,0,0,0,0,0,0,0,0,0,0,0,2,0,2,0,2,0,2,0,2,0,1,
		1,0,0,0,0,0,0,0,0,0,0,0,0,0,0,0,0,0,0,0,0,0,0,0,0,0,0,1,
		1,0,0,0,0,0,0,0,0,0,0,0,0,0,0,0,0,0,0,0,0,0,0,0,0,0,0,1,
		1,0,0,0,0,0,0,0,0,0,0,0,0,0,0,0,0,0,0,0,0,0,0,0,0,0,0,1,
		1,0,0,0,0,0,0,0,0,0,0,0,0,0,0,0,0,0,0,0,0,0,0,0,0,0,0,1,
		1,0,0,0,0,0,0,0,0,0,0,0,0,0,0,0,0,0,0,0,0,0,0,0,0,0,0,1,
		1,0,0,0,0,0,0,0,0,0,0,0,0,0,0,0,0,0,0,0,0,0,0,0,0,0,0,1,
		1,0,0,0,0,0,0,0,0,0,0,0,0,0,0,0,0,0,0,0,0,0,0,0,0,0,0,1,
		1,1,1,1,1,1,1,1,1,0,1,1,1,1,1,1,1,1,1,1,1,1,1,1,1,1,1,1
	],
	"map_row_len" : 28,
	"npcs" : [
		{
			"name" : "Suzi",
			"surname" : "Harrolds",
			"age" : 14,
			"x" : 60,
			"y" : 60,
			"hue" : 300,
			"gender" : "girl",
			"flags" : {},
			"text" : {
				"default" : [
					["Hello there um...."],
					["What do you want...", "can't you just leave me be?"],
					["Y-your not gonna-\nI'll call for help..."],
					["H-H-Heeeeelp!!!", "...", "A- Anyone?", {"setflag":{"text_state":"help"}}]
				],
				"help" : [
					["G-Go k-k-kill them q-quickly"],
					["H-H-Hurry I'm too y-young to d-d-d..."],
					["Please I'll do whatever you want if you save me"],
					["S-s-ssseriously... save me...", "Please", {"setflag":{"promice":true, "repeatln":true}}]
				]
			}
		}
	]
}